#SampleID	BarcodeSequence	LinkerPrimerSequence	Description
Sample.1	CCTAAACTACGGCCTAAACTACGG		Sample_1
Sample.2	CCTAAACTACGGTGCAGATCCAAC		Sample_2
Sample.3	CCTAAACTACGGCCATCACATAGG		Sample_3
Sample.4	CCTAAACTACGGGTGGTATGGGAG		Sample_4
Sample.5	CCTAAACTACGGACTTTAAGGGTG		Sample_5
Sample.6	CCTAAACTACGGGAGCAACATCCT		Sample_6
Sample.7	CCTAAACTACGGTGTTGCGTTTCT		Sample_7
Sample.8	CCTAAACTACGGATGTCCGACCAA		Sample_8
Sample.9	CCTAAACTACGGAGGTACGCAATT		Sample_9
Sample.10	CCTAAACTACGGACAGCCACCCAT		Sample_10
Sample.11	CCTAAACTACGGTGTCTCGCAAGC		Sample_11
Sample.13	CCTAAACTACGGGTTACGTGGTTG		Sample_13
Sample.14	CCTAAACTACGGTACCGCCTCGGA		Sample_14
Sample.15	CCTAAACTACGGCGTAAGATGCCT		Sample_15
Sample.16	CCTAAACTACGGTACCGGCTTGCA		Sample_16
Sample.17	CCTAAACTACGGATCTAGTGGCAA		Sample_17
Sample.18	CCTAAACTACGGCCAGGGACTTCT		Sample_18
Sample.20	CCTAAACTACGGATAGTTAGGGCT		Sample_20
Sample.1b	TGTTGCGTTTCTCCTAAACTACGG		Sample_1b
Sample.2b	TGTTGCGTTTCTTGCAGATCCAAC		Sample_2b
Sample.3b	TGTTGCGTTTCTCCATCACATAGG		Sample_3b
Sample.4b	TGTTGCGTTTCTGTGGTATGGGAG		Sample_4b
Sample.5b	TGTTGCGTTTCTACTTTAAGGGTG		Sample_5b
Sample.6b	TGTTGCGTTTCTGAGCAACATCCT		Sample_6b
Sample.7b	TGTTGCGTTTCTTGTTGCGTTTCT		Sample_7b
Sample.8b	TGTTGCGTTTCTATGTCCGACCAA		Sample_8b
Sample.9b	TGTTGCGTTTCTAGGTACGCAATT		Sample_9b
Sample.11b	TGTTGCGTTTCTTGTCTCGCAAGC		Sample_11b
Sample.12b	TGTTGCGTTTCTGAGGAGTAAAGC		Sample_12b
Sample.13b	TGTTGCGTTTCTGTTACGTGGTTG		Sample_13b
Sample.14b	TGTTGCGTTTCTTACCGCCTCGGA		Sample_14b
Sample.15b	TGTTGCGTTTCTCGTAAGATGCCT		Sample_15b
Sample.16b	TGTTGCGTTTCTTACCGGCTTGCA		Sample_16b
Sample.1c	ATGTCCGACCAACCTAAACTACGG		Sample_1c
Sample.2c	ATGTCCGACCAATGCAGATCCAAC		Sample_2c
Sample.3c	ATGTCCGACCAACCATCACATAGG		Sample_3c
Sample.4c	ATGTCCGACCAAGTGGTATGGGAG		Sample_4c
Sample.5c	ATGTCCGACCAAACTTTAAGGGTG		Sample_5c
Sample.6c	ATGTCCGACCAAGAGCAACATCCT		Sample_6c
Sample.7c	ATGTCCGACCAATGTTGCGTTTCT		Sample_7c
Sample.8c	ATGTCCGACCAAATGTCCGACCAA		Sample_8c
Sample.9c	ATGTCCGACCAAAGGTACGCAATT		Sample_9c
